Dusty Sandals
An Interactive Fiction by "Ilya Radchenko" Use American dialect, full-length room descriptions, and the serial comma
Release 1 / Serial number 160120 / Inform 7 build 6L38 (I6/v6.33 lib 6/12N) SD

Plain Road
The narrow road meanders through the hillside, overlooking the valley, and pressed up against the mount. To the west the road continues on towards the city and to the east back to the village.

>x city
The city lies in the distance, although it's hard to see from here, as it's across the valley.

* * *

Dusty Sandals
An Interactive Fiction by "Ilya Radchenko" Use American dialect, full-length room descriptions, and the serial comma
Release 1 / Serial number 160120 / Inform 7 build 6L38 (I6/v6.33 lib 6/12N) SD

Plain Road
The narrow road meanders through the hillside, overlooking the valley, and pressed up against the mount. To the west the road continues on towards the city and to the east back to the village.

>x chair
You can't see any such thing.

>x chairs
Four wooden chairs to go with the table.

>x candle
You can't see any such thing.

>x candles
Plain candles that are used for light once the sun goes down, or in rooms with no windows.

* * *

Dusty Sandals
An Interactive Fiction by "Ilya Radchenko" Use American dialect, full-length room descriptions, and the serial comma
Release 1 / Serial number 160120 / Inform 7 build 6L38 (I6/v6.33 lib 6/12N) SD

Plain Road
The narrow road meanders through the hillside, overlooking the valley, and pressed up against the mount. To the west the road continues on towards the city and to the east back to the village.

>e
There is nothing left for you in the village.

* * *

Dusty Sandals
An Interactive Fiction by "Ilya Radchenko" Use American dialect, full-length room descriptions, and the serial comma
Release 1 / Serial number 160120 / Inform 7 build 6L38 (I6/v6.33 lib 6/12N) SD

Plain Road
The narrow road meanders through the hillside, overlooking the valley, and pressed up against the mount. To the west the road continues on towards the city and to the east back to the village.

>actions
Actions listing on.

>test me
(Testing.)

>[1] w
[going west]

Road Near the Garden
This area looks more travelled, with trees scattered on one side and to the west there is a garden. The road to the village lies to the east.

[going west - succeeded]

>[2] w
[going west]

Garden Entrance
The road splits of towards the garden in the south, and the city in the west. Road lies to the east.

[going west - succeeded]

>[3] talk to group
That's not a verb I recognise.

* * *

Dusty Sandals
An Interactive Fiction by "Ilya Radchenko" Use American dialect, full-length room descriptions, and the serial comma
Release 1 / Serial number 160120 / Inform 7 build 6L38 (I6/v6.33 lib 6/12N) SD

Plain Road
The narrow road meanders through the hillside, overlooking the valley, and pressed up against the mount. To the west the road continues on towards the city and to the east back to the village.

>look
You open your eyes and see an unpleasent old-rugged merchant looking in through the damp hay.

>x
(Bread)
You see nothing special about Bread.

>i
You are carrying:
  Bread

>look
Dream
You roll over and gently sleep, as you dream of warm bread and goats milk. Zzzzzz...  Hey you hooligan! What do you think you're doing in MY cart? *crack* A sharp pain spreads through your head!

>look
Dream
You roll over and gently sleep, as you dream of warm bread and goats milk. Zzzzzz...  Hey you hooligan! What do you think you're doing in MY cart? *crack* A sharp pain spreads through your head!

* * *

>look
You open your eyes and see an unpleasent old-rugged merchant looking in through the damp hay.

>w
You can't go that way.

* * *

>look
You open your eyes and see an unpleasent old-rugged merchant looking in through the damp hay.

>go west
Broad Street
In the North you see a crowd in the distance, and two elderly woman. Looking to the South you see a group of Roman soldiers slowly approaching.

You can see a cart (in which is damp hay) here.

>look
Broad Street
In the North you see a crowd in the distance, and two elderly woman. Looking to the South you see a group of Roman soldiers slowly approaching.

You can see a cart (in which is damp hay) here.

>go north
You can't go that way.

>look
There's a alley to the West of you. This might be your only chance.

>open door
It doesn't budge.

>look
Broad Street
In the North you see a crowd in the distance, and two elderly woman. Looking to the South you see a group of Roman soldiers slowly approaching.

You can see a cart (in which is damp hay) here.

>look
Broad Street
In the North you see a crowd in the distance, and two elderly woman. Looking to the South you see a group of Roman soldiers slowly approaching.

You can see a cart (in which is damp hay) here.

>go west
Alley
A narrow alley. A woman in an old tunic is washing clothes next to her back-door, and a couple chickens run around beside her as she shoos them away.

>catch a chicken
That's not a verb I recognise.

* * *

>look
You open your eyes and see an unpleasent old-rugged merchant looking in through the damp hay.

>get into cart
That's not something you can enter.

>take cart
Taken.

>i
You are carrying:
  a cart

* * *

>look
You open your eyes and see an unpleasent old-rugged merchant looking in through the damp hay.

>look
Dream
You roll over and gently sleep, as you dream of warm bread and goats milk. Zzzzzz...  Hey you hooligan! What do you think you're doing in MY cart? *crack* A sharp pain spreads through your head!

>look
Empty Courtyard
An empty courtyard, with a hint of dust in the air. There are three exits, one East, through the main gates, another North through a small open door and the last to the West, which looks as if it's where the administrators come from.

>n
Narrow Passage

>look
Narrow Passage

* * *

>look
You open your eyes and see an unpleasent old-rugged merchant looking in through the damp hay.

>go n
You can't go that way.

>go w
Broad Street
In the North you see a crowd in the distance, and two elderly woman. Looking to the South you see a group of Roman soldiers slowly approaching.

You can see a cart (in which is damp hay) here.

* * *

Dusty Sandals
An Interactive Fiction by "Ilya Radchenko" Use American dialect, full-length room descriptions, and the serial comma
Release 1 / Serial number 160120 / Inform 7 build 6L38 (I6/v6.33 lib 6/12N) SD

Plain Road
The narrow road meanders through the hillside, overlooking the valley, and pressed up against the mount. To the west the road continues on towards the city and to the east back to the village.

>i
You are carrying:
  Bread

>eat bread
You eat Bread. Not bad.

>look
You open your eyes and see an unpleasent old-rugged merchant looking in through the damp hay.

* * *

>look
Dream
You roll over and gently sleep, as you dream of warm bread and goats milk. Zzzzzz...  Hey you hooligan! What do you think you're doing in MY cart? *crack* A sharp pain spreads through your head!

>go w
Broad Street
In the North you see a crowd in the distance, and two elderly woman. Looking to the South you see a group of Roman soldiers slowly approaching.

You can see a cart (in which is damp hay) here.

>go e
Dream
You roll over and gently sleep, as you dream of warm bread and goats milk. Zzzzzz...  Hey you hooligan! What do you think you're doing in MY cart? *crack* A sharp pain spreads through your head!

* * *

Dusty Sandals
An Interactive Fiction by "Ilya Radchenko" Use American dialect, full-length room descriptions, and the serial comma
Release 1 / Serial number 160120 / Inform 7 build 6L38 (I6/v6.33 lib 6/12N) SD

Plain Road
The narrow road meanders through the hillside, overlooking the valley, and pressed up against the mount. To the west the road continues on towards the city and to the east back to the village.

>w
Road Near the Garden
This area looks more travelled, with trees scattered on one side and to the west there is a garden. The road to the village lies to the east.

>x garden
The garden is in the distance.

You notice a cluster of torches moving throught the garden west towards the city.

>x garden
The garden is in the distance.

You notice a cluster of torches moving throught the garden west towards the city.

>e
Plain Road
The narrow road meanders through the hillside, overlooking the valley, and pressed up against the mount. To the west the road continues on towards the city and to the east back to the village.

>w
Road Near the Garden
This area looks more travelled, with trees scattered on one side and to the west there is a garden. The road to the village lies to the east.

>x garden
The garden is in the distance.

* * *

>w
Road Near the Garden
This area looks more travelled, with trees scattered on one side and to the west there is a garden. The road to the village lies to the east.

>x olvie
You can't see any such thing.

>x olive
You can't see any such thing.

>x olives
Many trees cover the hillside. The aroma they give off reminds you of olives.

* * *

>w
Road Near the Garden
This area looks more travelled, with trees scattered on one side and to the west there is a garden. The road to the village lies to the east.

>w
Garden Entrance
A group of people holding torches emerges from the garden. The road splits off towards the garden in the south, and the city in the west. Road lies to the east.

>w
City Road
The group continues towards the city.  The city walls rise up before you as you approach the city. The city gate is towards the west, and the garden is towards the east.

>x group
A group of soldiers, priests and other individuals are walking out of the garden towards the city. You notice one man in chains being pushed by the soldiers.

>actions
Actions listing on.

* * *

>x group
A group of soldiers, priests and other individuals are walking out of the garden towards the city. You notice one man in chains being pushed by the soldiers.

>e
Garden Entrance
The road splits off towards the garden in the south, and the city in the west. Road lies to the east.

>x group
You can't see any such thing.

* * *

>w
Garden Entrance
A group of people holding torches emerges from the garden. The road splits off towards the garden in the south, and the city in the west. Road lies to the east.

>x group
A group of soldiers, priests and other individuals are walking out of the garden towards the city. You notice one man in chains being pushed by the soldiers.

* * *

>actions
Actions listing on.

>w
[going west]

City Road
The group continues towards the city.  The city walls rise up before you as you approach the city. The city gate is towards the west, and the garden is towards the east.

[going west - succeeded]

* * *

>w
Road Near the Garden
This area looks more travelled, with trees scattered on one side and to the west there is a garden. The road to the village lies to the east.

>x road
You can't see any such thing.

* * *

>w
Road Near the Garden
This area looks more travelled, with trees scattered on one side and to the west there is a garden. The road to the village lies to the east.

>look
Open Chamber
An open area with a view of the overcast sky. The surroundings have an eerie feel about them.

* * *

>w
Road Near the Garden
This area looks more travelled, with trees scattered on one side and to the west there is a garden. The road to the village lies to the east.

>x tree
Many trees cover the hillside. The aroma they give off reminds you of olives.

>x olives
You can't see any such thing.

>x olive
Many trees cover the hillside. The aroma they give off reminds you of olives.

* * *

>w
Road Near the Garden
This area looks more travelled, with trees scattered on one side and to the west there is a garden. The road to the village lies to the east.

>n
Intersection
This is a small intersection, which goes east to west, and in the east you can see a big building, to the west are more houses. South of the intersection is the way to your house.

>w
You can't go that way.

>e
Big Building
Now that you have entered the building you realize it's a court building.There are several people seated in groups all over and to the north you see a set of stairs leading to the second floor. The exit is to the west.

>up
Second Floor
Not as spacious as the first floor, but still nice. Stairs lead back downstairs.

>d
Big Building
There are several people seated in groups all over and to the north you see a set of stairs leading to the second floor. The exit is to the west.

* * *

>w
Road Near the Garden
This area looks more travelled, with trees scattered on one side and to the west there is a garden. The road to the village lies to the east.

>take sandals
Finally, some shoes that I can wear!! My feet have been sore all week!

(first taking the pair of sandals)
Finally, some shoes that I can wear!! My feet have been sore all week!

(first taking the pair of sandals)
Finally, some shoes that I can wear!! My feet have been sore all week!

(first taking the pair of sandals)
Finally, some shoes that I can wear!! My feet have been sore all week!

(first taking the pair of sandals)
Finally, some shoes that I can wear!! My feet have been sore all week!

(first taking the pair of sandals)
Finally, some shoes that I can wear!! My feet have been sore all week!

(first taking the pair of sandals)
Finally, some shoes that I can wear!! My feet have been sore all week!

(first taking the pair of sandals)
Finally, some shoes that I can wear!! My feet have been sore all week!

(first taking the pair of sandals)
Finally, some shoes that I can wear!! My feet have been sore all week!

(first taking the pair of sandals)

*** Run-time problem P7: Too many rulebooks in simultaneous use.

>wear sandals
You put on the sandals.

>look
Open Chamber
An open area with a view of the overcast sky. The surroundings have an eerie feel about them.

>x
(the sandals)
You see nothing special about the sandals.

>me
That's not a verb I recognise.

>me
That's not a verb I recognise.

>i
You are carrying:
  a sandals (being worn)

* * *

>i
You are carrying nothing.

>me
That's not a verb I recognise.

>x
(the pair of sandals)
You see nothing special about the pair of sandals.

>look
Open Chamber
An open area with a view of the overcast sky. The surroundings have an eerie feel about them.

You can see a sandals here.

* * *

>x
(the pair of sandals)
You see nothing special about the pair of sandals.

>look me
Looking at yourself, you see the vague resemblance of an orphaned boy, about twelve or thirteen years of age. You are barefoot, and dressed in ragged clothing. Your hands are worn from the harsh conditions that you live in.

>wearing
That's not a verb I recognise.

>look
Open Chamber
An open area with a view of the overcast sky. The surroundings have an eerie feel about them.

You can see a pair of sandals here.

* * *

Dusty Sandals
An Interactive Fiction by "Ilya Radchenko" Use American dialect, full-length room descriptions, and the serial comma
Release 1 / Serial number 160120 / Inform 7 build 6L38 (I6/v6.33 lib 6/12N) SD

Plain Road
The narrow road meanders through the hillside, overlooking the valley, and pressed up against the mount. To the west the road continues on towards the city and to the east back to the village.

>x road
Which do you mean, the plain road valley, the plain road mount or the dusty road?

* * *

Dusty Sandals
An Interactive Fiction by "Ilya Radchenko" Use American dialect, full-length room descriptions, and the serial comma
Release 1 / Serial number 160120 / Inform 7 build 6L38 (I6/v6.33 lib 6/12N) SD

Plain Road
The narrow road meanders through the hillside, overlooking the valley, and pressed up against the mount. To the west the road continues on towards the city and to the east back to the village.

>x
What do you want to examine?

>me
Looking at yourself, you see the vague resemblance of an orphaned boy, about twelve or thirteen years of age. You are barefoot, and dressed in ragged clothing. Your hands are worn from the harsh conditions that you live in.

>look
The surroundings are bare, but you sense a sort of presence, as if something of real significance has just occurred in this dusty air that you breath.

>look
Empty Courtyard
An empty courtyard, with a hint of dust in the air. There are three exits, one East, through the main gates, another North through a small open door and the last to the West, which looks as if it's where the administrators come from.

>look
Empty Courtyard
An empty courtyard, with a hint of dust in the air. There are three exits, one East, through the main gates, another North through a small open door and the last to the West, which looks as if it's where the administrators come from.

* * *

Dusty Sandals
An Interactive Fiction by "Ilya Radchenko" Use American dialect, full-length room descriptions, and the serial comma
Release 1 / Serial number 160120 / Inform 7 build 6L38 (I6/v6.33 lib 6/12N) SD

Plain Road
The narrow road meanders through the hillside, overlooking the valley, and pressed up against the mount. To the west the road continues on towards the city and to the east back to the village.

>look cart
In the cart is Hay.

>x cart
The cart is empty.

>cart
That's not a verb I recognise.

>look in cart
The cart is empty.

>look at cart
The cart is empty.

* * *

Dusty Sandals
An Interactive Fiction by "Ilya Radchenko" Use American dialect, full-length room descriptions, and the serial comma
Release 1 / Serial number 160120 / Inform 7 build 6L38 (I6/v6.33 lib 6/12N) SD

Plain Road
The narrow road meanders through the hillside, overlooking the valley, and pressed up against the mount. To the west the road continues on towards the city and to the east back to the village.

>x valley
The valley extends out and from here the city is visible.

>v mount
That's not a verb I recognise.

>x mount
This side of the road is a mount, which rises upward out of your view.

>x hillside
This side of the road is a mount, which rises upward out of your view.

>x hill
This side of the road is a mount, which rises upward out of your view.

>x mountain
This side of the road is a mount, which rises upward out of your view.

* * *

Dusty Sandals
An Interactive Fiction by "Ilya Radchenko" Use American dialect, full-length room descriptions, and the serial comma
Release 1 / Serial number 160120 / Inform 7 build 6L38 (I6/v6.33 lib 6/12N) SD

Plain Road
The narrow road meanders through the hillside, overlooking the valley, and pressed up against the mount. To the west the road continues on towards the city and to the east back to the village.

>get into cart
That's not something you can enter.

* * *

Dusty Sandals
An Interactive Fiction by "Ilya Radchenko" Use American dialect, full-length room descriptions, and the serial comma
Release 1 / Serial number 160120 / Inform 7 build 6L38 (I6/v6.33 lib 6/12N) SD

Plain Road
The narrow road meanders through the hillside, overlooking the valley, and pressed up against the mount. To the west the road continues on towards the city and to the east back to the village.

>test me
(Testing.)

>[1] w

Road Near the Garden
This area looks more travelled, with trees scattered on one side and to the west there is a garden. The road to the village lies to the east.

>[2] w

Garden Entrance
A group of people holding torches emerges from the garden. The road splits of towards the garden in the south, and the city in the west. Road lies to the east.

>[3] talk to group
That's probably not a good idea, since you don't want to draw attention to yourself.

>x
(the group)
A group of soldiers, priests and other individuals are walking out of the garden towards the city. You notice one man in chains being pushed by the soldiers.

* * *

>test me
(Testing.)

>[1] w

Road Near the Garden
This area looks more travelled, with trees scattered on one side and to the west there is a garden. The road to the village lies to the east.

>[2] w

Garden Entrance
A group of people holding torches emerges from the garden. The road splits of towards the garden in the south, and the city in the west. Road lies to the east.

>[3] talk to group
That's probably not a good idea, since you don't want to draw attention to yourself.

>e
Road Near the Garden
This area looks more travelled, with trees scattered on one side and to the west there is a garden. The road to the village lies to the east.

>w
Garden Entrance
The road splits of towards the garden in the south, and the city in the west. Road lies to the east.

* * *

Dusty Sandals
An Interactive Fiction by "Ilya Radchenko" Use American dialect, full-length room descriptions, and the serial comma
Release 1 / Serial number 160120 / Inform 7 build 6L38 (I6/v6.33 lib 6/12N) SD

Plain Road
The narrow road meanders through the hillside, overlooking the valley, and pressed up against the mount. To the west the road continues on towards the city and to the east back to the village.

>l
Kitchen
A small and humble room, with a stove, table and four chairs. There are some candles on the table and a tea kettle on the stove. You can see the moon out the only window in the room.

>w
Tiny Street
A small street that runs north to south and is littered with several small houses.

>l
Tiny Street
A small street that runs north to south and is littered with several small houses.

>l
Tiny Street
A small street that runs north to south and is littered with several small houses.

* * *

>l
Kitchen
A small and humble room, with a stove, table and four chairs. There are some candles on the table and a tea kettle on the stove. You can see the moon out the only window in the room.

>n
North Gate
The gates archway looms over you as you look up, but that doesn't last long as you get bumped to move ahead!

* * *

>l
Kitchen
A small and humble room, with a stove, table and four chairs. There are some candles on the table and a tea kettle on the stove. You can see the moon out the only window in the room.

>l
Empty Courtyard
An empty courtyard, with a hint of dust in the air. There are three exits, one East, through the main gates, another North through a small open door and the last to the West, which looks as if it's where the administrators come from.

>l
Empty Courtyard
An empty courtyard, with a hint of dust in the air. There are three exits, one East, through the main gates, another North through a small open door and the last to the West, which looks as if it's where the administrators come from.

* * *

>l
Kitchen
A small and humble room, with a stove, table and four chairs. There are some candles on the table and a tea kettle on the stove. You can see the moon out the only window in the room.

>you
That's not a verb I recognise.

>l you
You can't see any such thing.

>x
What do you want to examine?

>x me
Looking at yourself, you see the vague resemblance of an orphaned boy, about twelve or thirteen years of age. You are barefoot, and dressed in ragged clothing. Your hands are worn from the harsh dusty weather of this region.

>remember
That's not a verb I recognise.

* * *

>l
Kitchen
A small and humble room, with a stove, table and four chairs. There are some candles on the table and a tea kettle on the stove. You can see the moon out the only window in the room.

>look
Empty Courtyard

* * *

>l
Kitchen
A small and humble room, with a stove, table and four chairs. There are some candles on the table and a tea kettle on the stove. You can see the moon out the only window in the room.

>x table
A simple wooden table.

* * *

Dusty Sandals
An Interactive Fiction by "Ilya Radchenko" Use American dialect, full-length room descriptions, and the serial comma
Release 1 / Serial number 160120 / Inform 7 build 6L38 (I6/v6.33 lib 6/12N) SD

Plain Road
The narrow road meanders through the hillside, overlooking the valley, and pressed up against the mount. To the west the road continues on towards the city and to the east back to the village.

>player
That's not a verb I recognise.

>i
You are carrying nothing.

>x
What do you want to examine?

>you
You can't see any such thing.

>look at self
Looking at yourself you see the vague resemblance of an orphaned boy, about twelve or thirteen years of age. You are barefoot, and dressed in ragged clothing.

* * *

Dusty Sandals
An Interactive Fiction by "Ilya Radchenko" Use American dialect, full-length room descriptions, and the serial comma
Release 1 / Serial number 160120 / Inform 7 build 6L38 (I6/v6.33 lib 6/12N) SD

Plain Road
The narrow road meanders through the hillside, overlooking the valley, and pressed up against the mount. To the west the road continues on towards the city and to the east back to the village.

>go w
Broad Street
In the North you see a crowd in the distance, and two elderly woman. Looking to the South you see a group of Roman soldiers slowly approaching.

You can see a cart (in which is damp hay) here.

>x door
You see several doors, but unfortunately all of them appear to be closed.

* * *

>go w
Broad Street
In the North you see a crowd in the distance, and two elderly woman. Looking to the South you see a group of Roman soldiers slowly approaching.

You can see a cart (in which is damp hay) here.

>look
Broad Street
In the North you see a crowd in the distance, and two elderly woman. Looking to the South you see a group of Roman soldiers slowly approaching.

You can see a cart (in which is damp hay) here.

>x some-doors
You see several doors, but unfortunately all of them appear to be closed.

* * *

>look
Broad Street
In the North you see a crowd in the distance, and two elderly woman. Looking to the South you see a group of Roman soldiers slowly approaching.

You can see a cart (in which is damp hay) here.

>lok door
That's not a verb I recognise.

>look door
These doors seem to be a waste of time.

>x doors
These doors seem to be a waste of time.

>open doors
That's not something you can open.

* * *

>look
Broad Street
In the North you see a crowd in the distance, and two elderly woman. Looking to the South you see a group of Roman soldiers slowly approaching.

You can see a cart (in which is damp hay) here.

>look door
The closest doors are next to the cart and across the street but unfortunately they appear to be closed.

* * *

>look
Broad Street
In the North you see a crowd in the distance, and two elderly woman. Looking to the South you see a group of Roman soldiers slowly approaching.

You can see a cart (in which is damp hay) here.

>look
There's a alley to the West of you. This might be your only chance.

>go w
Alley
A narrow alley. A woman in an old tunic is washing clothes next to her back-door, and a couple chickens run around beside her as she shoos them away.

>look
Alley
A narrow alley. A woman in an old tunic is washing clothes next to her back-door, and a couple chickens run around beside her as she shoos them away.

>i
You are carrying nothing.

* * *

>go w
Broad Street
In the North you see a crowd in the distance, and two elderly woman. Looking to the South you see a group of Roman soldiers slowly approaching.

You can see a cart (in which is damp hay) here.

>look door
These doors seem to be a waste of time.

>open door
It doesn't budge.

>open doors
It doesn't budge.

>look
Broad Street
You can see a cart (in which is damp hay) here.

* * *

Dusty Sandals
An Interactive Fiction by "Ilya Radchenko" Use American dialect, full-length room descriptions, and the serial comma
Release 1 / Serial number 160120 / Inform 7 build 6L38 (I6/v6.33 lib 6/12N) SD

Plain Road
The narrow road meanders through the hillside, overlooking the valley, and pressed up against the mount. To the west the road continues on towards the city and to the east back to the village.

>time
That's not a verb I recognise.

>check time
You can't see any such thing.

>date
That's not a verb I recognise.

>run
You'll have to say which compass direction to go in.

>run w
You can't go that way.

>run n
You can't go that way.

>look
Street
You can see a cart (in which is damp hay) here.

>get into cart
That's not something you can enter.

* * *

Dusty Sandals
An Interactive Fiction by "Ilya Radchenko" Use American dialect, full-length room descriptions, and the serial comma
Release 1 / Serial number 160120 / Inform 7 build 6L38 (I6/v6.33 lib 6/12N) SD

Plain Road
The narrow road meanders through the hillside, overlooking the valley, and pressed up against the mount. To the west the road continues on towards the city and to the east back to the village.

>look me
Looking at yourself, you see the vague resemblance of an orphaned boy, about twelve or thirteen years of age. You are barefoot, and dressed in ragged clothing. Your hands are worn from the harsh conditions that you live in.

>look
Street
You can see a cart (empty) here.

* * *

Dusty Sandals
An Interactive Fiction by "Ilya Radchenko" Use American dialect, full-length room descriptions, and the serial comma
Release 1 / Serial number 160120 / Inform 7 build 6L38 (I6/v6.33 lib 6/12N) SD

Plain Road
The narrow road meanders through the hillside, overlooking the valley, and pressed up against the mount. To the west the road continues on towards the city and to the east back to the village.

>x moon
A big bright moon shines over the entire city.

>l w
You see nothing unexpected in that direction.

* * *

Dusty Sandals
An Interactive Fiction by "Ilya Radchenko" Use American dialect, full-length room descriptions, and the serial comma
Release 1 / Serial number 160120 / Inform 7 build 6L38 (I6/v6.33 lib 6/12N) SD

Plain Road
The narrow road meanders through the hillside, overlooking the valley, and pressed up against the mount. To the west the road continues on towards the city and to the east back to the village.

>c road
That's not a verb I recognise.

>x road
The road is well travelled and dusty.

>x hill
This side of the road is a mount, which rises upward out of your view.

>x valley
The valley extends out and from here the city is visible.

* * *

Dusty Sandals
An Interactive Fiction by "Ilya Radchenko" Use American dialect, full-length room descriptions, and the serial comma
Release 1 / Serial number 160120 / Inform 7 build 6L38 (I6/v6.33 lib 6/12N) SD

Plain Road
The narrow road meanders through the hillside, overlooking the valley, and pressed up against the mount. To the west the road continues on towards the city and to the east back to the village.

>n
Darkness
It is pitch dark, and you can't see a thing.

* * *

Dusty Sandals
An Interactive Fiction by "Ilya Radchenko" Use American dialect, full-length room descriptions, and the serial comma
Release 1 / Serial number 160120 / Inform 7 build 6L38 (I6/v6.33 lib 6/12N) SD

Plain Road
The narrow road meanders through the hillside, overlooking the valley, and pressed up against the mount. To the west the road continues on towards the city and to the east back to the village.

>x stove
A stove built into the wall of the kitchen, used for cooking and heating the house.

>x chair
You can't see any such thing.

* * *

>x chairs
Four wooden chairs to go with the table.

>x table
A simple wooden table.

>take candles
That's hardly portable.

>l
Kitchen
A small and humble room, with a stove, table and four chairs. There are some candles on the table and a tea kettle on the stove. You can see the moon out the only window in the room.

>x window
You can't see any such thing.

>x moon
You can't see any such thing.